alley|allee|ally|aly
anex|annex|annx|anx
arcade|arc
avenue|av|aven|avenu|avn|avnue|ave
bayou|bayoo|byu
beach|bch
bend|bnd
bluff|bluf|blf
bluffs|blfs
bottom|bot|bottm|btm
boulevard|boul|boulv|blvd
branch|brnch|br
bridge|brdge|brg
brook|brk
brooks|brks
burg|bg
burgs|bgs
bypass|bypa|bypas|byps|byp
camp|cmp|cp
canyon|canyn|cnyn|cyn
cape|cpe
causeway|causwa|cswy
center|cen|cent|centr|centre|cnter|cntr|ctr
centers|ctrs
circle|circ|circl|crcl|crcle|cir
circles|cirs
cliff|clf
cliffs|clfs
club|clb
common|cmn
commons|cmns
corner|cor
corners|cors
course|crse
court|ct
courts|cts
cove|cv
coves|cvs
creek|crk
crescent|crsent|crsnt|cres
crest|crst
crossing|crssng|xing
crossroad|xrd
crossroads|xrds
curve|curv
dale|dl
dam|dm
divide|div|dvd|dv
drive|driv|drv|dr
drives|drs
estate|est
estates|ests
expressway|exp|expr|express|expw|expy
extension|extn|extnsn|ext
extensions|exts
falls|fls
ferry|frry|fry
field|fld
fields|flds
flat|flt
flats|flts
ford|frd
fords|frds
forest|forests|frst
forge|forg|frg
forges|frgs
fork|frk
forks|frks
fort|frt|ft
freeway|freewy|frway|frwy|fwy
garden|gardn|grden|grdn|gdn
gardens|grdns|gdns
gateway|gatewy|gatway|gtway|gtwy
glen|gln
glens|glns
green|grn
greens|grns
grove|grov|grv
groves|grvs
harbor|harb|harbr|hrbor|hbr
harbors|hbrs
haven|hvn
heights|ht|hts
highway|highwy|hiway|hiwy|hway|hwy
hill|hl
hills|hls
hollow|hllw|hollows|holws|holw
inlet|inlt
island|islnd|is
islands|islnds|iss
isles|isle
junction|jction|jctn|junctn|juncton|jct
junctions|jctns|jcts
key|ky
keys|kys
knoll|knol|knl
knolls|knls
lake|lk
lakes|lks
landing|lndng|lndg
lane|ln
light|lgt
lights|lgts
loaf|lf
lock|lck
locks|lcks
lodge|ldge|lodg|ldg
loops|loop
manor|mnr
manors|mnrs
meadow|mdw
meadows|medows|mdws
mill|ml
mills|mls
mission|missn|mssn|msn
motorway|mtwy
mount|mnt|mt
mountain|mntain|mntn|mountin|mtin|mtn
mountains|mntns|mtns
neck|nck
orchard|orchrd|orch
ovl|oval
overpass|opas
parks|park
parkway|parkwy|pkway|pky|parkways|pkwys|pkwy
passage|psge
paths|path
pikes|pike
pine|pne
pines|pnes
place|pl
plain|pln
plains|plns
plaza|plza|plz
point|pt
points|pts
port|prt
ports|prts
prairie|prr|pr
radial|rad|radiel|radl
ranch|ranches|rnchs|rnch
rapid|rpd
rapids|rpds
rest|rst
ridge|rdge|rdg
ridges|rdgs
river|rvr|rivr|riv
road|rd
roads|rds
route|rte
shoal|shl
shoals|shls
shore|shoar|shr
shores|shoars|shrs
skyway|skwy
spring|spng|sprng|spg
springs|spngs|sprngs|spgs
spurs|spur
square|sqr|sqre|squ|sq
squares|sqrs|sqs
station|statn|stn|sta
stravenue|strav|straven|stravn|strvn|strvnue|stra
stream|streme|strm
street|strt|str|st
streets|sts
summit|sumit|sumitt|smt
terrace|terr|ter
throughway|trwy
trace|traces|trce
track|tracks|trk|trks|trak
trafficway|trfy
trail|trails|trls|trl
trailer|trlrs|trlr
tunnel|tunel|tunls|tunnels|tunnl|tunl
turnpike|trnpk|turnpk|tpke
underpass|upas
union|un
unions|uns
valley|vally|vlly|vly
valleys|vlys
viaduct|vdct|viadct|via
view|vw
views|vws
village|vill|villag|villg|villiage|vlg
villages|vlgs
ville|vl
vista|vist|vst|vsta|vis
walks|walk
way|wy
well|wl
wells|wls
